{
    "start":{"row": 37, "column": 37},
    "end":  {"row": 37, "column":4},
    "grounds": [
        {
            "name": "Montanhoso",
            "id": "M",
            "cost": 200
        },
        {
            "name": "Plano",
            "id": "P",
            "cost": 1
        },
        {
            "name": "Rochoso",
            "id": "R",
            "cost": 5
        }
    ],
    "temples": [
        {
            "name": "Áries",
            "cost": 50,
            "position": {"row":37, "column":21}
        },
        {
            "name": "Touro",
            "cost": 55,
            "position": {"row":31, "column": 31}
        },
        {
            "name": "Gêmeos",
            "cost": 60,
            "position": {"row":31, "column": 32}
        },
        {
            "name": "Câncer",
            "cost": 70,
            "position":  {"row":24, "column": 23}
        },
        {
            "name": "Leão",
            "cost": 75,
            "position": {"row":24, "column": 9}
        },
        {
            "name": "Virgem",
            "cost": 80,
            "position": {"row":17, "column": 9}
        },
        {
            "name": "Libra",
            "cost": 85,
            "position": {"row":17, "column": 28}
        },
        {
            "name": "Escorpião",
            "cost": 90,
            "position": {"row":13, "column": 37}
        },
        {
            "name": "Sagitário",
            "cost": 95,
            "position": {"row":9, "column": 27}
        },
        {
            "name": "Capricórnio",
            "cost": 100,
            "position": {"row":9, "column": 14}
        },
        {
            "name": "Aquário",
            "cost": 110,
            "position": {"row":4, "column": 13}
        },
        {
            "name": "Peixes",
            "cost": 120,
            "position": {"row":4, "column": 30}
        }
    ],
    "map": [
        ["M", "M", "M", "M", "M", "M", "M", "M", "M", "M", "M", "M", "M", "M", "M", "M", "M", "M", "M", "M", "M", "M", "M", "M", "M", "M", "M", "M", "M", "M", "M", "M", "M", "M", "M", "M", "M", "M", "M", "M", "M", "M"],
        ["M", "M", "M", "M", "M", "M", "M", "M", "M", "M", "M", "M", "M", "M", "M", "M", "M", "M", "M", "M", "M", "M", "M", "M", "M", "M", "M", "M", "M", "M", "M", "M", "M", "M", "M", "M", "M", "M", "M", "M", "M", "M"],
        ["M", "M", "M", "M", "M", "M", "M", "M", "M", "M", "M", "M", "M", "M", "M", "M", "M", "M", "M", "M", "M", "M", "M", "M", "M", "M", "M", "M", "M", "M", "M", "M", "M", "M", "M", "M", "M", "M", "M", "M", "M", "M"],
        ["M", "M", "M", "R", "R", "R", "R", "R", "R", "R", "R", "R", "R", "M", "R", "R", "R", "R", "P", "P", "R", "P", "R", "P", "R", "R", "R", "R", "R", "R", "M", "R", "R", "R", "R", "R", "R", "R", "R", "M", "M", "M"],
        ["M", "M", "M", "R", "P", "P", "P", "R", "P", "R", "P", "R", "R", "_", "R", "R", "P", "R", "R", "R", "R", "P", "R", "P", "R", "P", "P", "P", "R", "R", "_", "R", "R", "R", "R", "R", "R", "R", "R", "M", "M", "M"],
        ["M", "M", "M", "R", "R", "R", "R", "R", "P", "R", "P", "R", "R", "M", "R", "R", "M", "R", "P", "P", "R", "R", "R", "R", "R", "P", "R", "P", "R", "R", "M", "R", "R", "R", "R", "R", "R", "R", "R", "M", "M", "M"],
        ["M", "M", "M", "R", "P", "P", "M", "M", "M", "M", "M", "M", "M", "M", "M", "M", "M", "M", "M", "M", "M", "M", "M", "M", "M", "M", "M", "M", "M", "M", "M", "M", "M", "M", "M", "M", "M", "M", "M", "M", "M", "M"],
        ["M", "M", "M", "R", "P", "R", "M", "M", "M", "M", "M", "M", "M", "M", "M", "M", "M", "M", "M", "M", "M", "M", "M", "M", "M", "M", "M", "M", "M", "M", "M", "M", "M", "M", "M", "M", "M", "M", "M", "M", "M", "M"],
        ["M", "M", "M", "R", "P", "R", "R", "P", "R", "R", "R", "R", "R", "R", "M", "R", "R", "R", "R", "R", "P", "R", "P", "R", "R", "R", "R", "M", "R", "R", "R", "R", "R", "P", "R", "R", "P", "R", "R", "M", "M", "M"],
        ["M", "M", "M", "R", "P", "R", "R", "P", "R", "P", "P", "P", "R", "R", "_", "R", "R", "P", "R", "R", "P", "R", "P", "P", "P", "R", "R", "_", "R", "R", "P", "R", "R", "P", "R", "R", "P", "P", "R", "M", "M", "M"],
        ["M", "M", "M", "R", "R", "R", "R", "R", "R", "R", "R", "P", "R", "R", "M", "R", "R", "P", "R", "R", "R", "R", "R", "R", "P", "R", "R", "M", "R", "R", "P", "R", "R", "R", "R", "R", "R", "R", "R", "M", "M", "M"],
        ["M", "M", "M", "M", "M", "M", "M", "M", "M", "M", "M", "M", "M", "M", "M", "M", "M", "M", "M", "M", "M", "M", "M", "M", "M", "M", "M", "M", "M", "M", "M", "M", "M", "M", "M", "M", "R", "P", "R", "M", "M", "M"],
        ["M", "M", "M", "M", "M", "M", "M", "M", "M", "M", "M", "M", "M", "M", "M", "M", "M", "M", "M", "M", "M", "M", "M", "M", "M", "M", "M", "M", "M", "M", "M", "M", "M", "M", "M", "M", "R", "R", "R", "M", "M", "M"],
        ["M", "M", "M", "M", "M", "M", "M", "M", "M", "M", "M", "M", "M", "M", "M", "M", "M", "M", "M", "M", "M", "M", "M", "M", "M", "M", "M", "M", "M", "M", "M", "M", "M", "M", "M", "M", "M", "_", "M", "M", "M", "M"],
        ["M", "M", "M", "M", "M", "M", "M", "M", "M", "M", "M", "M", "M", "M", "M", "M", "M", "M", "M", "M", "M", "M", "M", "M", "M", "M", "M", "M", "M", "M", "M", "M", "M", "M", "M", "M", "R", "R", "R", "M", "M", "M"],
        ["M", "M", "M", "M", "M", "M", "M", "M", "M", "M", "M", "M", "M", "M", "M", "M", "M", "M", "M", "M", "M", "M", "M", "M", "M", "M", "M", "M", "M", "M", "M", "M", "M", "M", "M", "M", "R", "R", "R", "M", "M", "M"],
        ["M", "M", "M", "R", "R", "R", "R", "P", "R", "M", "R", "R", "P", "R", "R", "R", "R", "R", "P", "R", "R", "R", "R", "R", "P", "R", "R", "R", "R", "M", "R", "R", "R", "R", "P", "P", "R", "P", "R", "M", "M", "M"],
        ["M", "M", "M", "R", "R", "R", "R", "P", "R", "_", "R", "P", "P", "R", "R", "P", "R", "R", "P", "R", "P", "P", "R", "R", "P", "R", "P", "P", "R", "_", "R", "R", "P", "R", "R", "P", "R", "P", "R", "M", "M", "M"],
        ["M", "M", "M", "P", "P", "R", "R", "R", "R", "M", "R", "R", "R", "R", "R", "P", "R", "R", "R", "R", "R", "P", "R", "R", "R", "R", "R", "R", "R", "M", "R", "R", "P", "R", "R", "P", "R", "P", "R", "M", "M", "M"],
        ["M", "M", "M", "R", "R", "R", "M", "M", "M", "M", "M", "M", "M", "M", "M", "M", "M", "M", "M", "M", "M", "M", "M", "M", "M", "M", "M", "M", "M", "M", "M", "M", "M", "M", "M", "M", "M", "M", "M", "M", "M", "M"],
        ["M", "M", "M", "P", "P", "R", "M", "M", "M", "M", "M", "M", "M", "M", "M", "M", "M", "M", "M", "M", "M", "M", "M", "M", "M", "M", "M", "M", "M", "M", "M", "M", "M", "M", "M", "M", "M", "M", "M", "M", "M", "M"],
        ["M", "M", "M", "R", "R", "R", "M", "M", "M", "M", "M", "M", "M", "M", "M", "M", "M", "M", "M", "M", "M", "M", "M", "M", "M", "M", "M", "M", "M", "M", "M", "M", "M", "M", "M", "M", "M", "M", "M", "M", "M", "M"],
        ["M", "M", "M", "R", "P", "R", "M", "M", "M", "M", "M", "M", "M", "M", "M", "M", "M", "M", "M", "M", "M", "M", "M", "M", "M", "M", "M", "M", "M", "M", "M", "M", "M", "M", "M", "M", "M", "M", "M", "M", "M", "M"],
        ["M", "M", "M", "R", "P", "R", "R", "R", "R", "M", "R", "R", "R", "R", "R", "P", "R", "R", "R", "R", "R", "R", "R", "P", "R", "R", "M", "R", "R", "R", "P", "R", "R", "P", "R", "R", "R", "R", "R", "M", "M", "M"],
        ["M", "M", "M", "R", "P", "P", "R", "P", "R", "_", "R", "R", "P", "P", "R", "P", "P", "P", "R", "P", "P", "P", "R", "P", "P", "R", "_", "R", "P", "R", "P", "P", "R", "P", "R", "P", "R", "R", "R", "M", "M", "M"],
        ["M", "M", "M", "R", "R", "R", "R", "P", "R", "M", "R", "R", "R", "R", "R", "R", "R", "P", "R", "P", "R", "R", "R", "R", "R", "R", "M", "R", "R", "R", "R", "R", "R", "R", "R", "P", "P", "P", "R", "M", "M", "M"],
        ["M", "M", "M", "M", "M", "M", "M", "M", "M", "M", "M", "M", "M", "M", "M", "M", "M", "M", "M", "M", "M", "M", "M", "M", "M", "M", "M", "M", "M", "M", "M", "M", "M", "M", "M", "M", "R", "R", "R", "M", "M", "M"],
        ["M", "M", "M", "M", "M", "M", "M", "M", "M", "M", "M", "M", "M", "M", "M", "M", "M", "M", "M", "M", "M", "M", "M", "M", "M", "M", "M", "M", "M", "M", "M", "M", "M", "M", "M", "M", "P", "P", "R", "M", "M", "M"],
        ["M", "M", "M", "M", "M", "M", "M", "M", "M", "M", "M", "M", "M", "M", "M", "M", "M", "M", "M", "M", "M", "M", "M", "M", "M", "M", "M", "M", "M", "M", "M", "M", "M", "M", "M", "M", "R", "R", "R", "M", "M", "M"],
        ["M", "M", "M", "M", "M", "M", "M", "M", "M", "M", "M", "M", "M", "M", "M", "M", "M", "M", "M", "M", "M", "M", "M", "M", "M", "M", "M", "M", "M", "M", "M", "M", "M", "M", "M", "M", "P", "P", "R", "M", "M", "M"],
        ["M", "M", "M", "R", "R", "R", "R", "P", "R", "R", "R", "R", "P", "R", "R", "R", "R", "M", "R", "R", "R", "R", "R", "R", "R", "P", "P", "P", "R", "R", "R", "P", "R", "M", "R", "P", "R", "P", "R", "M", "M", "M"],
        ["M", "M", "M", "P", "P", "P", "R", "P", "R", "P", "R", "R", "P", "R", "P", "P", "R", "_", "R", "R", "P", "R", "P", "P", "R", "P", "R", "R", "R", "R", "R", "P", "R", "_", "R", "P", "R", "P", "R", "M", "M", "M"],
        ["M", "M", "M", "R", "R", "R", "R", "R", "R", "P", "R", "R", "R", "R", "R", "R", "R", "M", "R", "R", "P", "R", "R", "P", "R", "P", "R", "R", "P", "P", "R", "R", "R", "M", "R", "R", "R", "R", "R", "M", "M", "M"],
        ["M", "M", "M", "R", "P", "P", "M", "M", "M", "M", "M", "M", "M", "M", "M", "M", "M", "M", "M", "M", "M", "M", "M", "M", "M", "M", "M", "M", "M", "M", "M", "M", "M", "M", "M", "M", "M", "M", "M", "M", "M", "M"],
        ["M", "M", "M", "R", "R", "R", "M", "M", "M", "M", "M", "M", "M", "M", "M", "M", "M", "M", "M", "M", "M", "M", "M", "M", "M", "M", "M", "M", "M", "M", "M", "M", "M", "M", "M", "M", "M", "M", "M", "M", "M", "M"],
        ["M", "M", "M", "R", "P", "P", "M", "M", "M", "M", "M", "M", "M", "M", "M", "M", "M", "M", "M", "M", "M", "M", "M", "M", "M", "M", "M", "M", "M", "M", "M", "M", "M", "M", "M", "M", "M", "M", "M", "M", "M", "M"],
        ["M", "M", "M", "R", "R", "P", "R", "R", "R", "R", "R", "R", "P", "R", "R", "R", "P", "R", "R", "P", "R", "M", "R", "R", "R", "R", "R", "R", "P", "R", "R", "R", "R", "R", "R", "R", "R", "R", "R", "M", "M", "M"],
        ["M", "M", "M", "R", "R", "P", "P", "P", "R", "P", "R", "R", "P", "R", "R", "P", "P", "P", "R", "P", "R", "_", "R", "P", "R", "P", "P", "R", "P", "R", "P", "R", "R", "P", "R", "R", "R", "S", "R", "M", "M", "M"],
        ["M", "M", "M", "R", "R", "R", "R", "R", "R", "P", "R", "R", "R", "R", "R", "R", "R", "R", "R", "P", "R", "M", "R", "P", "R", "R", "R", "R", "R", "R", "R", "R", "R", "P", "R", "R", "R", "R", "R", "M", "M", "M"],
        ["M", "M", "M", "M", "M", "M", "M", "M", "M", "M", "M", "M", "M", "M", "M", "M", "M", "M", "M", "M", "M", "M", "M", "M", "M", "M", "M", "M", "M", "M", "M", "M", "M", "M", "M", "M", "M", "M", "M", "M", "M", "M"],
        ["M", "M", "M", "M", "M", "M", "M", "M", "M", "M", "M", "M", "M", "M", "M", "M", "M", "M", "M", "M", "M", "M", "M", "M", "M", "M", "M", "M", "M", "M", "M", "M", "M", "M", "M", "M", "M", "M", "M", "M", "M", "M"],
        ["M", "M", "M", "M", "M", "M", "M", "M", "M", "M", "M", "M", "M", "M", "M", "M", "M", "M", "M", "M", "M", "M", "M", "M", "M", "M", "M", "M", "M", "M", "M", "M", "M", "M", "M", "M", "M", "M", "M", "M", "M", "M"]
    ]
}
