{
    "start": {"x": 36, "y":36},
    "end": {"x": 36, "y":36},

    "terrenos": {
        "Montanhoso": {
            "id": "M",
            "custo": 200
        },
        "Plano": {
            "id": "P",
            "custo": 1
        },
        "Rochoso": {
            "id": "R",
            "custo": 5
        },
    },
    "casas": {
        "Áries": {
            "cost": 50,
            "position": {"x":21, "y": 36}
        },
        "Touro": {
            "cost": 55,
            "position": {"x":18, "y": 30}
        },
        "Gêmeos": {
            "cost": 60,
            "position": {"x":34, "y": 30}
        },
        "Câncer": {
            "cost": 70,
            "position":  {"x":25, "y": 23}
        },
        "Leão": {
            "cost": 75,
            "position": {"x":9, "y": 23}
        },
        "Virgem": {
            "cost": 80,
            "position": {"x":9, "y": 16}
        },
        "Libra": {
            "cost": 85,
            "position": {"x":28, "y": 16}
        },
        "Escorpião": {
            "cost": 90,
            "position": {"x":37, "y": 13}
        },
        "Sagitário": {
            "cost": 95,
            "position": {"x":27, "y": 9}
        },
        "Capricórnio": {
            "cost": 100,
            "position": {"x":13, "y": 9}
        },
        "Aquário": {
            "cost": 110,
            "position": {"x":12, "y": 4}
        },
        "Peixes": {
            "cost": 120,
            "position": {"x":30, "y": 4}
        },
    }

    [
        /* 0 */
        ["M", "M", "M", "R", "R", "R", "R", "R", "M", "M", "M", "M", "M", "M", "M", "M", "M", "M", "M", "M", "M", "M", "M", "M", "M", "M", "M", "M", "M", "M", "M", "M", "M", "M", "M", "M", "M", "M", "M", "M", "M", "M"],
        /* 1 */
        ["M", "M", "M", "M", "M", "M", "M", "M", "M", "M", "M", "M", "M", "M", "M", "M", "M", "M", "M", "M", "M", "M", "M", "M", "M", "M", "M", "M", "M", "M", "M", "M", "M", "M", "M", "M", "M", "M", "M", "M", "M", "M"],
        /* 2 */
        ["M", "M", "M", "M", "M", "M", "M", "M", "M", "M", "M", "M", "M", "M", "M", "M", "M", "M", "M", "M", "M", "M", "M", "M", "M", "M", "M", "M", "M", "M", "M", "M", "M", "M", "M", "M", "M", "M", "M", "M", "M", "M"],
        /* 3 */
        ["M", "M", "M", "R", "R", "R", "R", "R", "R", "R", "R", "R", "R", "M", "R", "R", "R", "R", "P", "P", "R", "P", "R", "P", "R", "R", "R", "R", "R", "R", "M", "R", "R", "R", "R", "R", "R", "R", "R", "M", "M", "M"],
        /* 4 */
        ["M", "M", "M", "R", "P", "P", "P", "R", "P", "R", "P", "R", "R", "_", "R", "R", "P", "R", "R", "R", "R", "P", "R", "P", "R", "P", "P", "P", "R", "R", "_", "R", "R", "R", "R", "R", "R", "R", "R", "M", "M", "M"],
        /* 5 */
        ["M", "M", "M", "R", "R", "R", "R", "R", "P", "R", "P", "R", "R", "R", "R", "R", "M", "R", "P", "P", "R", "R", "R", "R", "R", "P", "R", "P", "R", "R", "_", "R", "R", "R", "R", "R", "R", "R", "R", "M", "M", "M"],
        /* 6 */
        ["M", "M", "M", "R", "P", "P", "M", "M", "M", "M", "M", "M", "M", "M", "M", "M", "M", "M", "M", "M", "M", "M", "M", "M", "M", "M", "M", "M", "M", "M", "M", "M", "M", "M", "M", "M", "M", "M", "M", "M", "M", "M"],
        /* 7 */
        ["M", "M", "M", "R", "P", "R", "M", "M", "M", "M", "M", "M", "M", "M", "M", "M", "M", "M", "M", "M", "M", "M", "M", "M", "M", "M", "M", "M", "M", "M", "M", "M", "M", "M", "M", "M", "M", "M", "M", "M", "M", "M"],
        /* 8 */
        ["M", "M", "M", "R", "P", "R", "R", "P", "R", "R", "R", "R", "R", "R", "M", "R", "R", "R", "R", "R", "P", "R", "P", "R", "R", "R", "R", "M", "R", "R", "R", "R", "R", "P", "R", "R", "P", "R", "R", "M", "M", "M"],
        /* 9 */
        ["M", "M", "M", "R", "P", "R", "R", "P", "R", "P", "P", "P", "R", "R", "_", "R", "R", "P", "R", "R", "P", "R", "P", "P", "P", "R", "R", "_", "R", "R", "P", "R", "R", "P", "R", "R", "P", "P", "R", "M", "M", "M"],
        /* 10 */
        ["M", "M", "M", "R", "R", "R", "R", "R", "R", "R", "R", "P", "R", "R", "M", "R", "R", "P", "R", "R", "R", "R", "R", "R", "P", "R", "R", "M", "R", "R", "P", "R", "R", "R", "R", "R", "R", "R", "R", "M", "M", "M"],
        /* 11 */
        ["M", "M", "M", "M", "M", "M", "M", "M", "M", "M", "M", "M", "M", "M", "M", "M", "M", "M", "M", "M", "M", "M", "M", "M", "M", "M", "M", "M", "M", "M", "M", "M", "M", "M", "M", "M", "R", "P", "R", "M", "M", "M"],
        /* 12 */
        ["M", "M", "M", "M", "M", "M", "M", "M", "M", "M", "M", "M", "M", "M", "M", "M", "M", "M", "M", "M", "M", "M", "M", "M", "M", "M", "M", "M", "M", "M", "M", "M", "M", "M", "M", "M", "R", "R", "R", "M", "M", "M"],
        /* 13 */
        ["M", "M", "M", "M", "M", "M", "M", "M", "M", "M", "M", "M", "M", "M", "M", "M", "M", "M", "M", "M", "M", "M", "M", "M", "M", "M", "M", "M", "M", "M", "M", "M", "M", "M", "M", "M", "M", "_", "M", "M", "M", "M"],
        /* 14 */
        ["M", "M", "M", "M", "M", "M", "M", "M", "M", "M", "M", "M", "M", "M", "M", "M", "M", "M", "M", "M", "M", "M", "M", "M", "M", "M", "M", "M", "M", "M", "M", "M", "M", "M", "M", "M", "R", "R", "R", "M", "M", "M"],
        /* 15 */
        ["M", "M", "M", "M", "M", "M", "M", "M", "M", "M", "M", "M", "M", "M", "M", "M", "M", "M", "M", "M", "M", "M", "M", "M", "M", "M", "M", "M", "M", "M", "M", "M", "M", "M", "M", "M", "R", "R", "R", "M", "M", "M"],
        /* 16 */
        ["M", "M", "M", "R", "R", "R", "R", "P", "R", "M", "R", "R", "P", "R", "R", "R", "R", "R", "P", "R", "R", "R", "R", "R", "P", "R", "R", "R", "R", "M", "R", "R", "R", "R", "P", "P", "R", "P", "R", "M", "M", "M"],
        /* 17 */
        ["M", "M", "M", "R", "R", "R", "R", "P", "R", "_", "R", "P", "P", "R", "R", "P", "R", "R", "P", "R", "P", "P", "R", "R", "P", "R", "P", "P", "R", "_", "R", "R", "P", "R", "R", "P", "R", "P", "R", "M", "M", "M"],
        /* 18 */
        ["M", "M", "M", "P", "P", "R", "R", "R", "R", "M", "R", "R", "R", "R", "R", "P", "R", "R", "R", "R", "R", "P", "R", "R", "R", "R", "R", "R", "R", "M", "R", "R", "P", "R", "R", "P", "R", "P", "R", "M", "M", "M"],
        /* 19 */
        ["M", "M", "M", "R", "R", "R", "M", "M", "M", "M", "M", "M", "M", "M", "M", "M", "M", "M", "M", "M", "M", "M", "M", "M", "M", "M", "M", "M", "M", "M", "M", "M", "M", "M", "M", "M", "M", "M", "M", "M", "M", "M"],
        /* 20 */
        ["M", "M", "M", "P", "P", "R", "M", "M", "M", "M", "M", "M", "M", "M", "M", "M", "M", "M", "M", "M", "M", "M", "M", "M", "M", "M", "M", "M", "M", "M", "M", "M", "M", "M", "M", "M", "M", "M", "M", "M", "M", "M"],
        /* 21 */
        ["M", "M", "M", "R", "R", "R", "M", "M", "M", "M", "M", "M", "M", "M", "M", "M", "M", "M", "M", "M", "M", "M", "M", "M", "M", "M", "M", "M", "M", "M", "M", "M", "M", "M", "M", "M", "M", "M", "M", "M", "M", "M"],
        /* 22 */
        ["M", "M", "M", "R", "P", "R", "M", "M", "M", "M", "M", "M", "M", "M", "M", "M", "M", "M", "M", "M", "M", "M", "M", "M", "M", "M", "M", "M", "M", "M", "M", "M", "M", "M", "M", "M", "M", "M", "M", "M", "M", "M"],
        /* 23 */
        ["M", "M", "M", "R", "P", "R", "R", "R", "R", "M", "R", "R", "R", "R", "P", "R", "R", "R", "R", "R", "R", "R", "P", "R", "R", "M", "R", "R", "R", "P", "R", "R", "P", "R", "R", "R", "R", "R", "R", "M", "M", "M"],


        /*END*/

        ["M", "M", "M", "M", "M", "M", "M", "M", "M", "M", "M", "M", "M", "M", "M", "M", "M", "M", "M", "M", "M", "M", "M", "M", "M", "M", "M", "M", "M", "M", "M", "M", "M", "M", "M", "M", "M", "M", "M", "M", "M", "M"],
        ["M", "M", "M", "M", "M", "M", "M", "M", "M", "M", "M", "M", "M", "M", "M", "M", "M", "M", "M", "M", "M", "M", "M", "M", "M", "M", "M", "M", "M", "M", "M", "M", "M", "M", "M", "M", "M", "M", "M", "M", "M", "M"],
        ["M", "M", "M", "M", "M", "M", "M", "M", "M", "M", "M", "M", "M", "M", "M", "M", "M", "M", "M", "M", "M", "M", "M", "M", "M", "M", "M", "M", "M", "M", "M", "M", "M", "M", "M", "M", "M", "M", "M", "M", "M", "M"],
    ],


}
