{
	"availableTime": 720,
    "start":{"row": 37, "column": 37},
    "end":  {"row": 4, "column":37},
    "grounds": [
        {
            "name": "Montanhoso",
            "id": "M",
            "cost": 200
        },
        {
            "name": "Plano",
            "id": "P",
            "cost": 1
        },
        {
            "name": "Rochoso",
            "id": "R",
            "cost": 5
        }
    ],
	"saints": [
		{
			"name": "Seiya", 
			"power": 1.5,
			"lives": 5
		},
		{
			"name": "Shiryu", 
			"power": 1.4,
			"lives": 5
		},
		{
			"name": "Hyoga", 
			"power": 1.3,
			"lives": 5
		},
		{
			"name": "Shun", 
			"power": 1.2,
			"lives": 5
		},
		{
			"name": "Ikki", 
			"power": 1.1,
			"lives": 5
		}
	],
    "temples": [
        {
            "name": "Áries",
            "difficulty": 50,
            "position": {"row":37, "column":21}
        },
        {
            "name": "Touro",
            "difficulty": 55,
            "position": {"row":31, "column": 17}
        },
        {
            "name": "Gêmeos",
            "difficulty": 60,
            "position": {"row":31, "column": 33}
        },
        {
            "name": "Câncer",
            "difficulty": 70,
            "position":  {"row":24, "column": 26}
        },
        {
            "name": "Leão",
            "difficulty": 75,
            "position": {"row":24, "column": 9}
        },
        {
            "name": "Virgem",
            "difficulty": 80,
            "position": {"row":17, "column": 9}
        },
        {
            "name": "Libra",
            "difficulty": 85,
            "position": {"row":17, "column": 29}
        },
        {
            "name": "Escorpião",
            "difficulty": 90,
            "position": {"row":13, "column": 37}
        },
        {
            "name": "Sagitário",
            "difficulty": 95,
            "position": {"row":9, "column": 27}
        },
        {
            "name": "Capricórnio",
            "difficulty": 100,
            "position": {"row":9, "column": 14}
        },
        {
            "name": "Aquário",
            "difficulty": 110,
            "position": {"row":4, "column": 13}
        },
        {
            "name": "Peixes",
            "difficulty": 120,
            "position": {"row":4, "column": 30}
        }
    ],
    "map": [
        ["M", "M", "M", "M", "M", "M", "M", "M", "M", "M", "M", "M", "M", "M", "M", "M", "M", "M", "M", "M", "M", "M", "M", "M", "M", "M", "M", "M", "M", "M", "M", "M", "M", "M", "M", "M", "M", "M", "M", "M", "M", "M"],
        ["M", "M", "M", "M", "M", "M", "M", "M", "M", "M", "M", "M", "M", "M", "M", "M", "M", "M", "M", "M", "M", "M", "M", "M", "M", "M", "M", "M", "M", "M", "M", "M", "M", "M", "M", "M", "M", "M", "M", "M", "M", "M"],
        ["M", "M", "M", "M", "M", "M", "M", "M", "M", "M", "M", "M", "M", "M", "M", "M", "M", "M", "M", "M", "M", "M", "M", "M", "M", "M", "M", "M", "M", "M", "M", "M", "M", "M", "M", "M", "M", "M", "M", "M", "M", "M"],
        ["M", "M", "M", "P", "P", "P", "P", "P", "P", "P", "P", "P", "P", "M", "P", "P", "P", "P", "R", "R", "P", "R", "P", "R", "P", "P", "P", "P", "P", "P", "M", "P", "P", "P", "P", "P", "P", "P", "P", "M", "M", "M"],
        ["M", "M", "M", "P", "R", "R", "R", "P", "R", "P", "R", "P", "P", "_", "P", "P", "R", "P", "P", "P", "P", "R", "P", "R", "P", "R", "R", "R", "P", "P", "_", "P", "P", "P", "P", "P", "P", "E", "P", "M", "M", "M"],
        ["M", "M", "M", "P", "P", "P", "P", "P", "R", "P", "R", "P", "P", "M", "P", "P", "R", "P", "R", "R", "P", "P", "P", "P", "P", "R", "P", "P", "P", "P", "M", "P", "P", "P", "P", "P", "P", "P", "P", "M", "M", "M"],
        ["M", "M", "M", "P", "R", "R", "M", "M", "M", "M", "M", "M", "M", "M", "M", "M", "M", "M", "M", "M", "M", "M", "M", "M", "M", "M", "M", "M", "M", "M", "M", "M", "M", "M", "M", "M", "M", "M", "M", "M", "M", "M"],
        ["M", "M", "M", "P", "R", "P", "M", "M", "M", "M", "M", "M", "M", "M", "M", "M", "M", "M", "M", "M", "M", "M", "M", "M", "M", "M", "M", "M", "M", "M", "M", "M", "M", "M", "M", "M", "M", "M", "M", "M", "M", "M"],
        ["M", "M", "M", "P", "R", "P", "P", "R", "P", "P", "P", "P", "P", "P", "M", "P", "P", "P", "P", "P", "R", "P", "R", "P", "P", "P", "P", "M", "P", "P", "P", "P", "P", "R", "P", "P", "R", "P", "P", "M", "M", "M"],
        ["M", "M", "M", "P", "R", "P", "P", "R", "P", "R", "R", "R", "P", "P", "_", "P", "P", "R", "P", "P", "R", "P", "R", "R", "R", "P", "P", "_", "P", "P", "R", "P", "P", "R", "P", "P", "R", "R", "P", "M", "M", "M"],
        ["M", "M", "M", "P", "P", "P", "P", "P", "P", "P", "P", "R", "P", "P", "M", "P", "P", "R", "P", "P", "P", "P", "P", "P", "R", "P", "P", "M", "P", "P", "R", "P", "P", "P", "P", "P", "P", "P", "P", "M", "M", "M"],
        ["M", "M", "M", "M", "M", "M", "M", "M", "M", "M", "M", "M", "M", "M", "M", "M", "M", "M", "M", "M", "M", "M", "M", "M", "M", "M", "M", "M", "M", "M", "M", "M", "M", "M", "M", "M", "P", "R", "P", "M", "M", "M"],
        ["M", "M", "M", "M", "M", "M", "M", "M", "M", "M", "M", "M", "M", "M", "M", "M", "M", "M", "M", "M", "M", "M", "M", "M", "M", "M", "M", "M", "M", "M", "M", "M", "M", "M", "M", "M", "P", "P", "P", "M", "M", "M"],
        ["M", "M", "M", "M", "M", "M", "M", "M", "M", "M", "M", "M", "M", "M", "M", "M", "M", "M", "M", "M", "M", "M", "M", "M", "M", "M", "M", "M", "M", "M", "M", "M", "M", "M", "M", "M", "M", "_", "M", "M", "M", "M"],
        ["M", "M", "M", "M", "M", "M", "M", "M", "M", "M", "M", "M", "M", "M", "M", "M", "M", "M", "M", "M", "M", "M", "M", "M", "M", "M", "M", "M", "M", "M", "M", "M", "M", "M", "M", "M", "P", "P", "P", "M", "M", "M"],
        ["M", "M", "M", "M", "M", "M", "M", "M", "M", "M", "M", "M", "M", "M", "M", "M", "M", "M", "M", "M", "M", "M", "M", "M", "M", "M", "M", "M", "M", "M", "M", "M", "M", "M", "M", "M", "P", "P", "P", "M", "M", "M"],
        ["M", "M", "M", "P", "P", "P", "P", "R", "P", "M", "P", "P", "R", "P", "P", "P", "P", "P", "R", "P", "P", "P", "P", "P", "R", "P", "P", "P", "P", "M", "P", "P", "P", "P", "R", "R", "P", "R", "P", "M", "M", "M"],
        ["M", "M", "M", "P", "P", "P", "P", "R", "P", "_", "P", "R", "R", "P", "P", "R", "P", "P", "R", "P", "R", "R", "P", "P", "R", "P", "R", "R", "P", "_", "P", "P", "R", "P", "P", "R", "P", "R", "P", "M", "M", "M"],
        ["M", "M", "M", "R", "R", "P", "P", "P", "P", "M", "P", "P", "P", "P", "P", "R", "P", "P", "P", "P", "P", "R", "P", "P", "P", "P", "P", "P", "P", "M", "P", "P", "R", "P", "P", "P", "P", "P", "P", "M", "M", "M"],
        ["M", "M", "M", "P", "P", "P", "M", "M", "M", "M", "M", "M", "M", "M", "M", "M", "M", "M", "M", "M", "M", "M", "M", "M", "M", "M", "M", "M", "M", "M", "M", "M", "M", "M", "M", "M", "M", "M", "M", "M", "M", "M"],
        ["M", "M", "M", "R", "R", "P", "M", "M", "M", "M", "M", "M", "M", "M", "M", "M", "M", "M", "M", "M", "M", "M", "M", "M", "M", "M", "M", "M", "M", "M", "M", "M", "M", "M", "M", "M", "M", "M", "M", "M", "M", "M"],
        ["M", "M", "M", "P", "P", "P", "M", "M", "M", "M", "M", "M", "M", "M", "M", "M", "M", "M", "M", "M", "M", "M", "M", "M", "M", "M", "M", "M", "M", "M", "M", "M", "M", "M", "M", "M", "M", "M", "M", "M", "M", "M"],
        ["M", "M", "M", "P", "R", "P", "M", "M", "M", "M", "M", "M", "M", "M", "M", "M", "M", "M", "M", "M", "M", "M", "M", "M", "M", "M", "M", "M", "M", "M", "M", "M", "M", "M", "M", "M", "M", "M", "M", "M", "M", "M"],
        ["M", "M", "M", "P", "R", "P", "P", "P", "P", "M", "P", "P", "P", "P", "P", "R", "P", "P", "P", "P", "P", "P", "P", "R", "P", "P", "M", "P", "P", "P", "R", "P", "P", "R", "P", "P", "P", "P", "P", "M", "M", "M"],
        ["M", "M", "M", "P", "R", "R", "P", "R", "P", "_", "P", "P", "R", "R", "P", "R", "R", "R", "P", "R", "R", "R", "P", "R", "R", "P", "_", "P", "R", "P", "R", "R", "P", "R", "P", "R", "P", "P", "P", "M", "M", "M"],
        ["M", "M", "M", "P", "P", "P", "P", "R", "P", "M", "P", "P", "P", "P", "P", "P", "P", "R", "P", "R", "P", "P", "P", "P", "P", "P", "M", "P", "P", "P", "P", "P", "P", "P", "P", "R", "R", "R", "P", "M", "M", "M"],
        ["M", "M", "M", "M", "M", "M", "M", "M", "M", "M", "M", "M", "M", "M", "M", "M", "M", "M", "M", "M", "M", "M", "M", "M", "M", "M", "M", "M", "M", "M", "M", "M", "M", "M", "M", "M", "P", "P", "P", "M", "M", "M"],
        ["M", "M", "M", "M", "M", "M", "M", "M", "M", "M", "M", "M", "M", "M", "M", "M", "M", "M", "M", "M", "M", "M", "M", "M", "M", "M", "M", "M", "M", "M", "M", "M", "M", "M", "M", "M", "R", "R", "P", "M", "M", "M"],
        ["M", "M", "M", "M", "M", "M", "M", "M", "M", "M", "M", "M", "M", "M", "M", "M", "M", "M", "M", "M", "M", "M", "M", "M", "M", "M", "M", "M", "M", "M", "M", "M", "M", "M", "M", "M", "P", "P", "P", "M", "M", "M"],
        ["M", "M", "M", "M", "M", "M", "M", "M", "M", "M", "M", "M", "M", "M", "M", "M", "M", "M", "M", "M", "M", "M", "M", "M", "M", "M", "M", "M", "M", "M", "M", "M", "M", "M", "M", "M", "R", "R", "P", "M", "M", "M"],
        ["M", "M", "M", "P", "P", "P", "P", "R", "P", "P", "P", "P", "R", "P", "P", "P", "P", "M", "P", "P", "P", "P", "P", "P", "P", "R", "R", "R", "P", "P", "P", "R", "P", "M", "P", "R", "P", "R", "P", "M", "M", "M"],
        ["M", "M", "M", "R", "R", "R", "P", "R", "P", "R", "P", "P", "R", "P", "R", "R", "P", "_", "P", "P", "R", "P", "R", "R", "P", "R", "P", "P", "P", "P", "P", "R", "P", "_", "P", "R", "P", "R", "P", "M", "M", "M"],
        ["M", "M", "M", "P", "P", "P", "P", "P", "P", "R", "P", "P", "P", "P", "P", "P", "P", "M", "P", "P", "R", "P", "P", "R", "P", "R", "P", "P", "R", "R", "P", "P", "P", "M", "P", "P", "P", "P", "P", "M", "M", "M"],
        ["M", "M", "M", "P", "R", "R", "M", "M", "M", "M", "M", "M", "M", "M", "M", "M", "M", "M", "M", "M", "M", "M", "M", "M", "M", "M", "M", "M", "M", "M", "M", "M", "M", "M", "M", "M", "M", "M", "M", "M", "M", "M"],
        ["M", "M", "M", "P", "P", "P", "M", "M", "M", "M", "M", "M", "M", "M", "M", "M", "M", "M", "M", "M", "M", "M", "M", "M", "M", "M", "M", "M", "M", "M", "M", "M", "M", "M", "M", "M", "M", "M", "M", "M", "M", "M"],
        ["M", "M", "M", "P", "R", "R", "M", "M", "M", "M", "M", "M", "M", "M", "M", "M", "M", "M", "M", "M", "M", "M", "M", "M", "M", "M", "M", "M", "M", "M", "M", "M", "M", "M", "M", "M", "M", "M", "M", "M", "M", "M"],
        ["M", "M", "M", "P", "P", "R", "P", "P", "P", "P", "P", "P", "R", "P", "P", "P", "R", "P", "P", "R", "P", "M", "P", "P", "P", "P", "P", "P", "R", "P", "P", "P", "P", "P", "P", "P", "P", "P", "P", "M", "M", "M"],
        ["M", "M", "M", "P", "P", "R", "R", "R", "P", "R", "P", "P", "R", "P", "P", "R", "R", "R", "P", "R", "P", "_", "P", "R", "P", "R", "R", "P", "R", "P", "R", "P", "P", "R", "P", "P", "P", "S", "P", "M", "M", "M"],
        ["M", "M", "M", "P", "P", "P", "P", "P", "P", "R", "P", "P", "P", "P", "P", "P", "P", "P", "P", "R", "P", "M", "P", "R", "P", "P", "P", "P", "P", "P", "P", "P", "P", "R", "P", "P", "P", "P", "P", "M", "M", "M"],
        ["M", "M", "M", "M", "M", "M", "M", "M", "M", "M", "M", "M", "M", "M", "M", "M", "M", "M", "M", "M", "M", "M", "M", "M", "M", "M", "M", "M", "M", "M", "M", "M", "M", "M", "M", "M", "M", "M", "M", "M", "M", "M"],
        ["M", "M", "M", "M", "M", "M", "M", "M", "M", "M", "M", "M", "M", "M", "M", "M", "M", "M", "M", "M", "M", "M", "M", "M", "M", "M", "M", "M", "M", "M", "M", "M", "M", "M", "M", "M", "M", "M", "M", "M", "M", "M"],
        ["M", "M", "M", "M", "M", "M", "M", "M", "M", "M", "M", "M", "M", "M", "M", "M", "M", "M", "M", "M", "M", "M", "M", "M", "M", "M", "M", "M", "M", "M", "M", "M", "M", "M", "M", "M", "M", "M", "M", "M", "M", "M"]
    ]
}
